10 10
##########
#        #
#####    #
#        #
#  P BT  #
#        #
#  ###   #
#    #   #
#    #   #
##########