10 6
##########
##1### 1 #
#   ## B #
#   ### ##
# P ## T #
##########