10 8
##########
# 1 ##   #
#   ## 1 #
# B ##   #
#   ##   #
#   ## T #
#   P    #
##########