10 6
##########
#        #
#   B    #
#  P  T  #
#        #
##########