20 9
####################
########     #2#   #
#T             # B #
###########    #DDD#
#2##########       #
#K## 1#   ###     ##
####### B ###### ###
# P          1   ###
####################