10 10
##########
#        #
#####    #
#        #
#  PBBT  #
#     T  #
#  ###   #
#    #   #
#    #   #
##########