10 10
##########
###      #
# B      #
# ##### ##
#   T    #
## P T   #
######   #
###### B##
######  ##
##########