10 6
##########
##   1 ###
#  B   DT#
#    #####
#  P #1 K#
##########