20 10
####################
#######T     #######
###########    ##  #
#        #     ##B #
#  P     #         #
#    T      ########
## ##########   ####
#             B ####
#    #         #####
####################