20 10
####################
####   ###   ##   ##
## B               #
## #  ##    B#### ##
##   ######  #  #  #
######  ######     #
# B     #  TPT  ####
#   #       T    ###
####################
####################