20 13
####################
#T#1        2#   DT#
#D############   ###
#                #3#
#     #5#   ##   # #
###   ##    ##   # #
#4#      B       #2#
# ###  B P B     ###
# ##     B  ##     #
#5##        1#     #
###   ############D#
#TD   #4    K   3#T#
####################