20 10
####################
##   #     #       #
#  1    ## # 2 B   #
##    B #3 #      3#
###     #  #########
#########   ########
#  T    ##  ## T  ##
#      1 #  #  2  ##
#        P       ###
####################